1111111111111111111111111111111111
1P00000000000001000001000000000001
1111111100000000111111100000000001
100000000000C0000000000000000000E1
1111111111111111111111111111111111