1111111111111111111111111111111111
1P000000000000001000001000000C0001
1000000000000000111011100000000001
100000C000000000100000000000000001
1000000000010000000000000000000001
1000000000010000C000000000000000E1
1111111111111111111111111111111111